University
===========

to failed - завалил
a bachelor's degree-степень бакалавра
a campus-кампус
a community - сообщество
a college-колледж
a course-курс (предмет)
a credit-зачет
a degree-степень
a dorm-общая спальня
to enroll-Записаться
an exam-экзамен
faculty-факультет
fail-незачет

financial aid-финансовая помощь
fraternity-студенческая мужская организация
graduate-выпускник
instructor-инструктор
lecture-лекция
major-основной
master's degree-степень магистра
matriculate-быть принятым в высшее учебное заведение
notebook-блокнот
notes-записи

textbook-учебник
transcript-стенограмма
trimester-триместр
tuition-обучение
undergraduate-студент
university-Университет

To see - понимать
To inrole - поступить в институт
To apply - подать документы
dean - деканат
office - комната не для студентов (например где профкома и деканат)
department - кафедра, отдел

Head of the department - заведующий кафедры

chansaler - ректор
wise chansaler -проректор

pass-пропуск
PhD-кандидат наук
postgraduate-аспирант
professor-профессор

register-регистр
research-исследование
research-исследование

room and board-проживание и питание
roommate-сосед по комнате
semester-семестр

sorority-университетский женский клуб
spring break-весенний перерыв
syllabus-учебный план


where is dean office
Student ID = student card
First year student - frash amri
I am in my first year
school subject == university course

credit and exams - зачет и экзамен
credit book - зачетка
lectures - преподаватель
workshop - семинар
credit list - ведомость пустая

credit report - заполненная ведомость
backlogs - долги
To matter - иметь значение
mandatary - обязательный
drop out university - отчислиться

to clock in - отметиться при входе
to clock out - отметиться при выходе

What are you interested? - о хобби
To attend - присутствовать
a pressure - давление

approach - стремиться (аппроксимировать)
i wish - жаль
Boundary Conditions - граничные условия
vector - направление

Translation
============

to suggest - предлагать
a derivative - производная
implicit - неявный
explicit - явный
a series - ряд (Teylor series)
to stumble - натыкаться
contemplating - рассматривая
a glimpse - проблеск
an area - площадь
thikness - произвольный
thin - тонкий
snugly - плотно
precise - точный
quantities - величины
to conclude - заключать
a precision - точность

a gear - механизм
to gear - готовиться
the rest - остальные
expensive - дорогой
handy - удобный
a tenet - принцип
a gap - пробел
to expect - ожидать
backwards compatibility - обратная совместимость
homogenous - однородный
occupies - занимает
exposing - раскрывающий, демонстрирующий
a strides - шаги
consumed - потребляемый
a quantity – величина
a equation - уравнение
assumption – предположение
a particle – частица
a frequency – частота
nuclear – ядерный
constellation – созвездие
a black hole – черная дыра
a eclipse – затмение
a hemisphere – полушарие
a frontier – граница
a covenant – договоренность
prosperous – процветающий
diversity – разнообразие
a species – вид
a tissue – ткань
extermination – уничтожение
chemical bond – химическая связь
alienation – отчуждение
probably sampling – случайная выборка
addiction – зависимость
perception – восприятие
burnout – истощение
a preposition – предлог
collocation – словосочетание
polysemy – многозачность
to express – выражать
crude – сырой
slices - слои
conjugate - сопряженный
cumulative - совокупный
restriction - ограничение
pickle - консервированный
surface - поверхность
pinned down - прижать, связать
dogged - упорный
a clause - пункт
to hold - держать
a evidence - доказательства
a recession - спад